NO ./assets/no_texture.xpm
SO ./assets/so_texture.xpm
WE ./assets/we_texture.xpm
EA ./assets/ea_texture.xpm

C 224, 255, 255
F 15, 17, 8

        111111111111111111111111
        1000000000110000000000001
        10110S0001110000001000001
        100100000000000000000001
111111111011000001110000000000001
100000000011000001110111101111111
11110111111111011100000010001
1111011111111011101010010001
11000000110101011100000010001
10001000000000001100000010001
1000000000000000011010100100011
1100000111010101111101111000011
11110111 1110101 101111010001
11111111 1111111 111111111111
